    0  0  0  0  0  0  0  0  0  0  0  0  0  0  0  0  0  0  0  0  0  0  0  0  0  0  0  0  0  0  0  0  0  0  0  0  0  0  0  0
    0  0  0  1  1  0  0  0  0  0  0  0  0  0  0  18  0  0  0  0 34 34 34  2  2  0  0  0  0  0  0  0  0  0  0  0  0  0  0  0
    0  0  0  1  1  1  0  0 30 28 28 28 28 28 28 28 28 31  0  0 34 34 34 34  2  2  0  0  0  30 28 28 31 0  0  1  1  0  0  0
    0  0  0  0  1  1  0  0 26 21 21 21 21 21 21 21 21 27 31  0  0 34 34  2  2  0  0  0  0  26 21 21 25 0  0  0  1  1  0  0
    0  0  0  0  0  0  0  0 32 23 23 23 23 23 23 24 21 21 27 31  0  0  0  0  0  0  0  0  0  26 21 21 25 0  0  0  1  0  0  0
    0  0  0  0 34  0  0  0  0  0  0  0  0  0  0 32 24 21 21 27 28 28 28 28 31  0  0  0  0  32 23 23 33 0  0  0  0  0  0  0
    0  0  0 34 34 34 34  0  0  0  0  1  1  1  1  0 32 24 21 21 21 21 21 21 25  0  0  0  1  1  1  0  0  0  0  1  1  0  0  0
    0  0  0 34 34 34  6  7  7  7  7  7  7  8  1  1  0 26 21 22 23 23 23 23 33  0  0 34 34 34  1  0  0  0  1  1  1  0  0  0
    0  0  0  0 34 34  9  4  4  4  4  4  4 10  1  1  0 26 21 25  0 19 20  0  0  0  0 34 34 34 34  0  0  0  1  1  1  1  0  0
    7  7  7  7  7  7 17  4  4  5  4  4  4 16  7  8  0 26 21 25  0  6  7  7  7  7  7  7  7  7  8  0  0  0  6  7  7  7  7  7
    4  4  4  4  4  5  4  4  4  4  5  4  4  4  4 10  0 26 21 25  0  9  4  4  4  4  4  4  4  4 10  0  0  0  9  4  4  4  5  4
    4  4  5  5  4  4  4  4  4  4  4  4  4  5  4 10  0 26 21 25  0 11 12 15  4  5  4  5  4  4 10  0  0  0  9  4  4  4  4  4
    4  4  4  4  4  4  4 14 12 12 12 12 12 12 12 13  0 26 21 25  0  0  0  9  4  4  4  4  5  4 10  0  0  0  9  4  5  4  4  4
   12 12 12 12 12 12 12 13  0  0  0  0  0  0  0  0  0 26 21 25  0  0  0 11 12 12 12 12 12 12 13  0  0  0 11 12 12 12 12 12
    0  0  0  0  0  0  0  0  0  0  0  0  0  0  0  0  0 26 21 25  0  0  0  0  0  0  0  0  0  2  2  0  0  0  0  0 34 34 34 34
    0  0  0  0  0  0  0  0  0  0 30 28 28 28 28 28 28 29 21 27 28 28 28 28 28 28 31  0  0  0  2  2  0  0  0  0  0 34 34 34
    0  0  0  0  0  0  0  0  0  0 26 21 21 21 21 21 21 21 21 21 21 21 21 21 21 21 27 28 31  0  0  0  0  0  0  0  0  0 34 34
    0  0  0  0  1  1 34  0  0  0 32 23 23 23 23 23 23 24 21 22 23 23 23 23 24 21 21 21 27 28 28 31  0  0  0  0  0  0  0  0
    0  0  0  0 34 34 34 34  0  3  0  0  0  0  0  0  0 26 21 25  0  0  0  0 32 24 21 21 21 21 21 25  0  0  0  0  2  0  0  0
    0  0  0  0 34 34 34  0  0  3  3  3  0  0  0  0  0 26 21 25  0  0  0  0  0 32 23 23 23 23 23 33  0  0  0  2  2  0  0  0
    0  0  0  0  0 34 34  0  0  3  0  3  3  0  0  0  0 32 23 33  0  0  18  0  0  0  0  0  0  0  0  0  0  0  0  2  2  0  0  0
    0  0  0  0  0  0  0  0  0  0  0  0  0  0  0  0  0  0  0  0  0  0  0  0  0  0  0  0  0  0  0  0  0  0  0  0  0  0  0  0
    0  0  0  0  0  0  0  0  0  0  0  0  0  0  0  0  0  0  0  0  0  0  0  0  0  0  0  0  0  0  0  0  0  0  0  0  0  0  0  0