4  5 17  4  5 16 14 29 29 29  0  0  0  0  0  0 29 29 29 29 29 29 29 29  0  0  0  0  0  0  0  0  
4  4  5 16  9 14 29 29 29  0 21 22  0  0  0 18  7 15 29 29 29  0  0  1  1 19  0  0  0  0  0  0
5 16  9 14  0  0  0  0  0  0 23 24  0  0  0  7  8 13  1  3  0 19  0  3  1  1  0 21 27 22  0  0
9 14  0  0  0  0  0  1 18  0  0  0  0  0  7  8 16 14  1  2  0  0  0  1  1  3 21 20 20 26  0  0
0  0  0  0  0  0  1  2  1  1  0  0  0  0 10  9 14 29  29 0  0  0  0  0  1  0 23 28 24  0  0  0
0 21 22  0  0  0  1  2  2  0  0 21 27 22  0  0  0  0  0  0  0  0  0  0  0  0  0  0  0  0  0  0
0 25 20 26  0  0  0  0  0  0  0 25 20 20 27 27 22  0  0  0  0  0  0 29 29 29  2  0  0  2  2  2
0  0 23 24  0  0  0  0  0  0  0 23 28 28 20 20 26  0  0  0  0  0  2  2  2  2  3  0  0  0  2  2
0  0  0  0  0 19  0  0 29  1  0  0  0  0 25 20 26  7  6  6  6  6 15  3  2  2  0  0  0  3  2  2
0  0  0  2  2  0  0  0  1  1  1  7  6 15 25 20 26 12  5 17 16  9 14  2  2  2  2  0  0  2  2  2
0  0  0  2  2 29  0  0  7  6  6  8 16 14 25 20 26 10  9  9 14  0  0  0  0  0  0  0  0  0  0  0
0  0  0 29 29  0  0  7  8  5 16  9 14  0 25 20 20 27 27 27 27 27 22  0  0  0  0  0  0  0  0  0  
0  0  0  0  0  0  7  8 17 16 14  0  0  0 23 28 28 28 28 28 20 20 26  0  0  0  0  0  1  1  0  0
0  0  7  6  6  6  8  4  5 13  0  0  0  0  0 18  3  2  0  0 25 20 26  0 21 27 22  0  1  1  2 29
6  6  8  4  4  4  5 16  9 14  0 21 22  0 29  2  2  2  3  0 23 20 20 27 20 20 26  0  1  2  2 29  
4  4  4  5  4 17  4 13  0  0  0 23 24  0  3  2  2  2 29  0  0 25 20 20 20 26  0 19  0  2  2 29
4  5 17  4  4  4  5 13  0  0  0  0  0  0  0  2  2  0  0  0  0 23 28 28 28 24  0 29 29 29 29 29
4  4  4  5  4  4  4 11 15  0  0  0  0  0  0  0  0  0  0  0  0  0  0  0  0 29 29 29 29 29 29 29
